0001111100
1000000000
0000100000
0000100111
0000000000
0000000100
0000000100
0000000100
0000000100
0000000000