1000000000
1000000000
0000100000
0000000111
0000000000
0000000001
0011111001
0000000001
0000000001
0000000000